.......................#
.......#...............
.......#....###....#...
...........#.....#.....
........!........#.....
..........#.....@....
.......#.......#####...
.........#........#....
...............#.......
###########............
.......................
......#........#.......
.......................
............#..........
.......................
.......................